TILEMAP
36 28 							-- Size of tile map in tiles
16 32 							-- Tile size & block size
images/blocks.png 	-- Tilesheet
2 2 								-- Number of tiles in tilesheet
1,1,1,1,1,1,1,1,1,1,1,1,1,1,1,1,1,1,1,1,1,1,1,1,1,1,1,1,1,1,1,1,1,1,1,1
1,1                                1,1
1,1                                1,1
1,1                                1,1
1,1                                1,1
1,1                                1,1
1,1                                1,1
1,1,1,1   1,1,1,1,1   1   1   1,1,1,1,1,1   1,1,1,1
1,1           1 1 1 1 1            1,1
1,1                                1,1
1,1                                1,1
1,1                                1,1
1,1,1,1   1,1,1,1   3,3   4,4   1,1,1,1,1   1,1,1,1
1,1                                1,1
1,1                                1,1
1,1              1,1,1               1,1
1,1                                1,1
1,1,1,1   1,1,1  2,2       2,2  1,1,1,1   1,1,1,1
1,1            2,2   2,2             1,1
1,1             2,2,2,2,2              1,1
1,1                                1,1
1,1                                1,1
1,1,1,1   1,1,1,1,1,1,1,1,1,1,1,1,1,1,1,1,1,1,1,1,1,1   1,1,1,1
1,1                                1,1
1,1                                1,1
1,1                                1,1
1,1                                1,1
1,1,1,1,1,1,1,1,1,1,1,1,1,1,1,1,1,1,1,1,1,1,1,1,1,1,1,1,1,1,1,1,1,1,1,1

